111111111111111
100000000000001
101111111110111
101110000000111
101110111111111
100000000000001
101110111111101
100000111111101
111111111111111